10 10

0 0 0 0 0 0 0 0 0 0 
0 2 2 2 2 2 2 2 0 0 
0 2 2 2 2 2 2 2 0 0 
0 2 2 2 2 2 2 2 0 0 
0 2 2 2 2 2 2 2 2 2 
0 2 2 2 0 2 2 2 0 0 
0 2 14 14 2 2 2 2 0 0 
0 2 14 14 0 2 2 2 0 0 
0 2 2 2 0 2 2 2 0 0 
0 0 0 0 0 0 0 0 0 0 

3 3 3 3 3 3 3 3 3 3 
3 4 4 4 4 0 0 0 3 3 
3 4 4 4 0 0 0 0 3 3 
3 4 4 4 0 0 0 0 3 3 
3 4 4 4 4 0 0 0 0 0 
3 8 9 9 10 0 0 0 3 3 
3 8 0 0 25 0 0 0 3 3 
3 8 0 0 10 0 0 0 3 3 
3 8 9 9 10 0 0 0 3 3 
3 3 3 3 3 3 3 3 3 3 

0 0 0 0 0 0 0 0 0 0 
0 0 0 0 0 0 0 0 0 0 
0 0 0 0 0 0 0 0 0 0 
0 0 0 0 0 0 0 0 0 0 
0 0 0 0 0 0 0 0 0 0 
0 0 0 0 0 0 0 0 0 0 
0 0 0 0 0 0 0 0 0 0 
0 0 0 0 0 0 0 0 0 0 
0 0 0 0 0 0 0 0 0 0 
0 0 0 0 0 0 0 0 0 0 

0 0 0 0 0 0 0 0 0 0 
0 0 0 0 0 0 0 0 0 0 
0 0 0 0 21 0 0 0 0 0 
0 0 0 0 0 0 0 0 0 0 
0 0 0 0 0 0 0 0 1 0 
0 0 0 0 0 0 0 0 0 0 
0 0 13 0 0 0 0 0 0 0 
0 0 13 0 0 0 0 0 0 0 
0 0 0 0 0 0 0 0 0 0 
0 0 0 0 0 0 0 0 0 0 
