7 7

0 0 2 2 2 0 0 
0 3 3 2 3 3 0 
2 3 2 2 2 3 2 
2 2 2 2 2 2 2 
2 3 2 2 2 3 2 
0 3 3 3 3 3 0 
0 0 0 0 0 0 0 

3 3 0 0 0 3 3 
3 3 3 0 3 3 3 
0 3 0 0 0 3 0 
0 0 0 0 0 0 0 
0 3 4 4 4 3 0 
3 3 3 3 3 3 3 
3 3 3 3 3 3 3 

0 0 0 0 0 0 0 
0 0 0 0 0 0 0 
0 0 0 0 0 0 0 
0 0 0 0 0 0 0 
0 0 0 0 0 0 0 
0 0 0 0 0 0 0 
0 0 0 0 0 0 0 

0 0 0 0 0 0 0 
0 0 0 1 0 0 0 
0 0 0 0 0 0 0 
0 1 0 0 0 1 0 
0 0 0 0 0 0 0 
0 0 0 0 0 0 0 
0 0 0 0 0 0 0 
